%%%%%%%%%%
%P.......%
% %%%%%% %
%.       %
%%%%%%%%%%
